.....╔══╩═══╗...............................
════╗║......║......█........................
.╔══╬╝..╔═══╣...╗..║........................
.║..║...║...╚═╦═╝╚╦╝........................
.╚╦═╩═══╣.....║...║.........................
..╚══...║.....╚═══╝.........................
........║........╔══════╗...................
........╚╦═══════╝.  .╔═╝╚╦.................
.........╬═══█........║.....................
.........║............║.....................
.........║............╚═════════════════════
.........║..................................
.........║..................................
.........║..................................
.........║..................................