.....╔══════╗...........║......╔╦═╗.......
════╗║......║......█....╚╗....╔╬╝.█.........
.╔══╬╝..╔═══╣...╗..║.....╚═══╦╩╝............
.║..║...║...╚═╦═╝╚╦╝.........╠═══════╦═█═╗..
.╚╦═╩═══╣.....║...║.....╔═█═╗║.......╚═╦═╝..
..╚═════╬═════╩═══╝.....║...╠╣.╔═╗.╔═╗.║....
..█╗....║........╔══════╬═══╝╚╗║.║.║.║.║.█..
╔══╝....╚╦═══════╝..█...╠══╦══╝║.╚═╝.╚═╝.║..
╚══╗.╔╗..╠═══█......╚═══╝..║...║.╔═╗.╔═╗.║..
..╔╩═╩╝..║.╔═╗.╔═╗.╔═╗.....║...║.║.║.║.║.║..
..╚╗╔═╗█╔╝.║.╚═╝.╚╦╝.╚═════╣...╚═╝.╚═╝.╚═╣..
...╚╝.╚╩╝..║......║...█....║...█══╗╔═╗╔═╗║..
...........█......║...╚════╬╗.....╠╣.╠╣.╠╣.╔
..................╚════════╝║..█══╝╚═╝╚═╝╚═╝
............................║...............