.....╔══════╗...............................
════╗║......║......█........................
.╔══╬╝..╔═══╣...╗..║........................
.║..║...║...╚═╦═╝╚╦╝........................
.╚╦═╩═══╣.....║...║.........................
..╚══...║.....╚═══╝.........................
........║........╔══════╗...................
........╚╦═══════╝.  .╔═╝╚╦.................
.........╬═══█........║.....................
......................║.....................
......................╚═════════════════════
............................................
............................................
............................................
............................................